1111111111
1C00C001C1
1E1P100111
1111111111