11111111111111111111111111111
1P100000000000000000000000011
100100000000M0000000000001111
11000C10000000100010001111111
1111111110000000000011111M111
11111111111000100011111111111
11111111111110E11111110111111
11111111111111111111111111111