11111111111111111
1C00C00C1100101E1
1PC00000001000C01
100000C000M000001
10000C0000000C001
11111111111111111