111111111
1C000M0C1
1PC000001
1C00000E1
111111111