1111111111
1C00C00MC1
1E1P100111
1111111111