111111111
1C00MM0C1
1PCM00001
1C00M00E1
111111111