11111111111111111111111111111111
1C00000C11001010C10000M110010101
1PC00000M01000C0C1000000100M0011
1000000000000C000100000010000001
1000CC0000E00C000100000010000001
11111111111111111111111111111111