111111111
1C00000C1
1PC000001
1C000M0E1
111111111