1111111111
10000M00P1
1000000000
1E00000111
10110100C1
1110001100
1111111111
