111111111
1TYUI0001
1P000E001
1CM00C0C1
111111111