1111111111
1P001C1001
1000101011
1000000E01
1111111111