1111111111
1C000000P1
1C0000C001
1E00C000C1
1111111111