11111111111
1E000000P11
1111111C111
11111111111
11111111111