11111111111
1E000000001
1000000C001
10000P00001
11111111111