1111111111
1C000000P1
1C0000C001
1E00C0011
1111111111
987897