1111111111
1P000C00C1
1000C00001
1C000000E1
1111111111