1111111111
10000000P1
1000000001
1E00000111
1011011101
1110001101
1111111111
