11111111111111111111111111111
1P0000000000000000000000000C1
11110000000000000000000001111
11111110000000000000001111111
11111111100000000000111111111
11111111111000C00011111111111
11111111111111E11111111111111
11111111111111111111111111111