1111111111
10000P1101
100C11C001
10C00100E1
1111111111