1111111111
1M000P11M1
100C11C001
10C00100E1
1111111111