1111111111
10M0P0P001
1E0000C001
1111111111