1111111111
1000P0P001
1E0000C001
1111111111