11111111
10M00000P1
1001E00C1
111111111