11111111
10000000P1
1001000C1
111111111